type octile
height 14
width 44
map
@@@@@@@@@@@@@@@@@@@@@@@@@@@@@@@@@@@@@@@@@@..
@@@@@@@@@@@@@@@@@@@@@@@@@@@@@@..............
@@@@@@@@@@@@@@@@@@@@@@@@@@@@@@..............
@@@@@@@@@@@@@@@@@@@@@@@@@@@@@@..............
@@@@.....@@@@.@@@@..@@@@@@@@@@..............
@@@@.....@@@@.@@@@..@@@@@@@@@@..............
@@@@.....@@@@.@@@@..@@@@@@@@@@..............
@@@@@@@..@@@@.@@@@..@@@@@@@@@@..............
@@@@@@@.....................................
@@@@@@@...@@@@@@@...........................
@@@@@@@...@@@@@@@...........................
@.........@@@@@@@...........................
@...........................................
@...........................................
