..............@.@.@@@@@@@@@@@@@@@@@@@.............
.............@@@@@@@@@@@@@@@@@@@@@@@@@............
............@@.......................@@...........
...........@@.........................@@..........
..........@@...........................@@.........
.........@@.............................@@........
........@@...............................@@.......
.......@@.................................@@......
......@@...................................@@.....
.....@@.....................................@@....
....@@.......................................@@...
...@@.........................................@@..
..@@...........................................@@@
.@@.............................................@@
.@...............................................@
................................................@.
@@..............................................@@
@@..............................................@@
@.................................................
@@..............................................@.
@@..............................................@@
@@................................................
.@..............................................@@
.@..............................................@@
@@...............................................@
.@................................................
.@@.............................................@@
..@@...........................................@@.
...@@.........................................@@..
....@@.......................................@@...
.....@@.....................................@@....
......@@...................................@@.....
.......@@.................................@@......
........@@...............................@@.......
.........@@.............................@@........
..........@@...........................@@.........
...........@@.........................@@..........
............@@.......................@@...........
.............@@@@@@@@@@@@@@@@@@@@@@@@@............
