type octile
height 7
width 22
map
@@@@@@@@@@@@@@@.......
@@@@@@@@@@@@@@@.......
@@...@@@..@@@@@.......
@@...@@@..@@@@@.......
@@@@..................
@@@@..@@@.............
......................
