type octile
height 12
width 37
map
.........................@@@@@@@@@@@.
.........................@...........
.........................@...........
..@@@@@@@@@@@@@@@@.......@...........
..@@....@@@.@@@@.@.......@...........
..@@....@.@.@..@.@.......@...........
..@@@.@.@.@.@..@.@@@@@@@@@...........
..@@@.@..........@@@@@@@@............
@@@@@....@@@@@@......................
@..@@.@..@@@@@@......................
@....................................
@....................................

